NNNNNNNNNNNNNBCNNNNNNNNNNNNNNNNNNNNCBNNNNNNNNNNNNN
NNNNNNNNNNNNNBCNNNNNNNNNNNNNNNNNNNNCBNNNNNNNNNNNNN
NNFFBBBBBBBNNNNNNBBBBBBBNNBBBBBBBNNNNNNBBBBBBBFFNN
NNFFBBBBBBBNNNNNNBBBBBBBNNBBBBBBBNNNNNNBBBBBBBFFNN
NNNNNNNNNNNNNBBNNNNNNNNNNNNNNNNNNNNBBNNNNNNNNNNNNN
NNNNNNNNNNNNNBBNNNNNNNNNNNNNNNNNNNNBBNNNNNNNNNNNNN
NNWWBBBBBBBNNBBNNBBBBBBBNNBBBBBBBNNBBNNBBBBBBBWWNN
NNWWBBBBBBBNNBBNNBBBBBBBNNBBBBBBBNNBBNNBBBBBBBWWNN
NNNNNNNNNNNNNNNNNNNNNNNNNNNNNNNNNNNNNNNNNNNNNNNNNN
NNNNNNNNNNNNNNNNNNNNNNNNNNNNNNNNNNNNNNNNNNNNNNNNNN
NNBBBBBBBNNBBNNBBBBBBNNNNNNNNBBBBBBNNBBNNBBBBBBBNN
NNBBBBBBBNNBBNNBBBBBBNNBBBBNNBBBBBBNNBBNNBBBBBBBNN
NNNNNNCCNNNNNNNNBBNNNNNBNNBNNNNNBBNNNNNNNNCCNNNNNN
NNNNNNCCNNNNNNNNBBNNNNNBNNBNNNNNBBNNNNNNNNCCNNNNNN
NNBBBBBBBNNBBNNBBBBBBNNBBBBNNBBBBBBNNBBNNBBBBBBBNN
NNBBBBBBBNNBBNNBBBBBBNNNNNNNNBBBBBBNNBBNNBBBBBBBNN
NNNNNNNNNNNNNNNNNNNNNNNNNNNNNNNNNNNNNNNNNNNNNNNNNN
NNNNNNNNNNNNNNNNNNNNNNNNNNNNNNNNNNNNNNNNNNNNNNNNNN
NNWWBBBBBBBNNBBNNBBBBBBBNNBBBBBBBNNBBNNBBBBBBBWWNN
NNWWBBBBBBBNNBBNNBBBBBBBNNBBBBBBBNNBBNNBBBBBBBWWNN
NNNNNNNNNNNNNBBNNNNNNNNNNNNNNNNNNNNBBNNNNNNNNNNNNN
NNNNNNNNNNNNNBBNNNNNNNNNNNNNNNNNNNNBBNNNNNNNNNNNNN
NNFFBBBBBBBNNNNNNBBBBBBBNNBBBBBBBNNNNNNBBBBBBBFFNN
NNFFBBBBBBBNNNNNNBBBBBBBNNBBBBBBBNNNNNNBBBBBBBFFNN
NNNNNNNNNNNNNBCNNNNNNNNNNNNNNNNNNNNCBNNNNNNNNNNNNN
NNNNNNNNNNNNNBCNNNNNNNNNNNNNNNNNNNNCBNNNNNNNNNNNNN